111111
1E10C1
111011
100P11
111111
