1111111111
1P000 0001
1000000001
10000000C1
1000000001
1000000001
1000000001
1000000011
1000000E01
1111111111
