111111
1E11C1
101011
101P11
111111
