111111
1010C1
101E01
100P11
111111
