1111111111111111111111111111111111111111111
1000000000000000000000000000000000000000001
1000000000000000000000000000000000000000001
1000000000000000000000000000000000000000001
100000000C000000000000000000000000000000001
1000000000000000000000000000000000000000001
10000000000000000000000000000000000C0000001
1000000000000000000000000000000000000000001
10000000000000000000000000000E0000000000101
10000000000000000000C0000000000000000000101
1000000000000000000000000000000000000000101
1000000000000000000000000000000000000000101
1000000000000111110000000000000000000000101
1000000000000000000000000000000000000000101
1C00000000000000000000000000000000000000001
1000000000000000000000000000000C00000000001
1000000000000000000000000000000C00000000001
1000000000000000000000000000000C00000000001
1000000000000000000000000000000000000000001
1000000000000000000000000000000000000000001
1P00000000000000000000000000000000000000001
1111111111111111111111111111111111111111111
